+-+-+-+-+-+-+-+-+-+-+
      |     | |   | |
+-+-+ +-+-+ + +-+ + +
| |   | |   |   | | |
+ +-+ + +-+ +-+ + + +
|     | | | |   | | |
+-+-+ + + + +-+ + + +
| |             | | |
+ +-+-+-+-+-+-+ + + +
|     | | |         |
+-+-+ + + +-+-+-+ + +
| | |       |   |   |
+ + +-+-+-+ +-+ +-+ +
|     |       |     |
+-+-+ +-+-+-+ +-+ + +
| |     | |   |     |
+ +-+-+ + +-+ +-+-+ +
|   | |       |     |
+ + + + +-+-+ + + + +
|                    
+-+-+-+-+-+-+-+-+-+-+
